5
-.-.-.-.A
-.-.-.-.G
-.-.-.-.-
-.W.-.-.-
-.-.-.-.-