5
-.-.-.-.A
-.-.-.-.G
-.-.-.-.-
-.W.A.-.-
-.-.-.-.-