10
-.-.-.-.-.P.-.-.-.W
-.W.-.W.-.-.-.-.-.-
-.-.-.-.P.-.-.G.-.-
-.-.-.-.-.-.-.-.-.-
W.P.-.W.-.G.-.-.G.-
-.-.W.-.-.-.-.-.-.-
A.-.-.-.-.P.-.-.-.W
-.-.G.-.-.-.-.-.-.-
-.-.-.-.-.-.G.-.-.-
W.P.W.-.G.-.-.G.-.-