5
-.-.-.-.A
-.-.-.-.-
-.P.-.-.-
-.P.P.-.-
-.-.P.-.-