5
-.-.-.-.A
-.-.-.-.-
-.W.-.-.-
-.P.W.-.-
-.-.W.-.-