5
-.-.-.-.-
-.-.-.-.G
-.-.-.-.-
-.W.-.-.A
-.-.-.-.-