10
G.W.-.-.-.-.-.-.W.G
W.-.P.P.-.-.P.-.W.G
-.-.-.-.-.W.-.-.W.W
P.-.-.-.-.-.-.-.-.G
-.-.W.-.W.-.P.-.-.-
-.-.-.-.-.-.-.-.-.-
-.G.-.-.-.W.-.-.-.-
W.W.P.-.W.A.W.-.P.-
-.W.W.-.-.W.-.-.-.-
-.W.W.-.-.-.-.-.-.-