10
-.-.-.-.-.-.-.-.-.-
-.-.-.A.-.-.P.-.-.-
-.-.-.-.-.W.-.-.-.-
-.-.-.-.-.-.-.-.-.-
-.-.W.-.W.-.P.-.-.-
-.-.-.-.-.-.-.-.-.-
P.G.-.-.-.W.-.-.-.-
-.-.-.-.W.-.P.-.P.-
-.-.-.-.-.-.-.-.-.-
-.-.-.-.-.-.-.-.-.-