10
-.-.-.-.-.-.-.-.-.-
-.-.-.-.-.-.P.-.-.G
-.-.-.-.-.W.-.-.-.-
P.-.-.-.-.-.-.-.-.G
P.P.W.-.W.-.P.-.-.-
-.-.-.-.-.-.-.-.-.-
-.G.-.-.-.W.-.-.-.-
-.-.-.-.W.A.P.-.P.-
W.W.-.-.-.-.-.-.-.-
-.W.-.-.-.-.-.-.-.-