10
-.-.-.-.-.-.-.-.-.-
-.-.G.P.-.W.-.-.-.-
-.-.-.-.W.G.W.-.W.-
G.-.-.-.P.W.-.-.-.-
A.-.-.-.-.-.-.-.-.-
-.-.-.-.-.-.W.-.-.-
-.-.-.W.G.P.P.-.-.-
-.-.-.-.W.W.-.-.-.-
G.-.-.-.W.-.-.-.-.-
-.-.-.P.-.-.-.-.-.G