10
G.W.-.-.-.-.-.-.W.G
W.-.-.-.-.-.P.-.W.G
-.-.-.-.-.W.-.-.W.W
P.-.-.-.-.-.-.-.-.G
P.P.W.-.W.-.P.-.-.-
-.-.-.-.-.-.-.-.-.-
-.G.-.-.-.W.-.-.-.-
W.W.W.-.W.A.W.-.P.-
W.W.W.-.-.W.-.-.-.-
-.P.W.-.-.-.-.-.-.-